NO ./textures/grass.xpm
SO ./textures/metal.xpm
WE ./textures/stone.xpm
EA ./textures/brick.xpm
F 255,255,255
C 255,255,255

111111
1N0001
100001
111111