NO ./textures/grass.xpm
SO ./textures/metal.xpm
WE ./textures/stone.xpm
EA ./textures/brick.xpm
F 0,0,0
C 0,0,0

111111
1N0001
100001
111111