NO ./textures/Wall2.xpm
SO ./textures/Wall7.xpm
WE ./textures/Wall4.xpm
EA ./textures/Wall8.xpm

F 123, 123, 123
C 123, 123, 100

 1111111111111111111111111111111111
100000000000000000000000000000000001
100000000000000000000000000000000001
100000000000000000000000000000000001
100000000000000000000000000000000001
100000000000010000000000000000000001
100000000000001000000000000000000001
100000000000000100000000000000000001
100000000000000000000000000000000001
1000000000000N0000000000000000000001
100000000000000000000000000000000001
100000000000000000000000000000000001
100000000000000000000000000000000001
100000000000000000000000000000000001
100000000000000000000000000000000001
100000000000000000000000000000000001
100000000000000000000000000000000001
100000000000000000000000000000000001
 1111111111111111111111111111111111