F 100,150,200
NO ./textures/grass.xpm
C 10,20,30
WE ./textures/stone.xpm
SO ./textures/metal.xpm
EA ./textures/brick.xpm

111111
1E0001
100001
111111